{
  "Map": {
    "Tiles": [
      [ 2, 2, 2, 2, 2, 2, 2, 2, 2, 2, 2, 2 ],
      [ 2, 2, 2, 2, 2, 2, 2, 2, 2, 2, 2, 2 ],
      [ 2, 2, 2, 2, 2, 2, 2, 2, 2, 2, 2, 2 ],
      [ 1, 1, 1, 1, 1, 1, 1, 1, 1, 1, 1, 1 ],
      [ 1, 1, 1, 1, 1, 1, 1, 1, 1, 1, 1, 1 ],
      [ 1, 1, 1, 1, 1, 1, 1, 1, 1, 1, 1, 1 ],
      [ 1, 1, 1, 1, 1, 1, 1, 1, 1, 1, 4, 1 ],
      [ 1, 1, 1, 1, 1, 1, 1, 1, 1, 1, 1, 1 ],
      [ 1, 1, 1, 1, 1, 1, 1, 1, 1, 1, 1, 1 ],
      [ 2, 2, 2, 2, 2, 2, 2, 2, 2, 2, 2, 2 ],
      [ 2, 2, 2, 2, 2, 2, 2, 2, 2, 2, 2, 2 ],
      [ 2, 2, 2, 2, 2, 2, 2, 2, 2, 2, 2, 2 ]
    ]
  },
  "Character": {
    "Position": {
      "x": 1,
      "y": 4
    },
    "Direction": "Right"
  },
  "Units": [
    {
      "Cost": 1,
      "UnitId": "Coin",
      "Position": {
        "x": 3,
        "y": 7
      }
    },
    {
      "Cost": 1,
      "UnitId": "Coin",
      "Position": {
        "x": 6,
        "y": 7
      }
    },
    {
      "Cost": 1,
      "UnitId": "Coin",
      "Position": {
        "x": 6,
        "y": 4
      }
    }
  ]
}