{
  "Map": {
    "Tiles": [
      [ 2, 2, 2, 0, 2, 2, 2, 2, 2, 2, 0, 2 ],
      [ 0, 1, 1, 1, 1, 1, 1, 1, 1, 1, 1, 2 ],
      [ 2, 1, 1, 1, 1, 1, 1, 1, 1, 1, 1, 2 ],
      [ 2, 1, 1, 1, 1, 1, 1, 0, 0, 0, 1, 2 ],
      [ 2, 1, 1, 1, 1, 1, 1, 0, 0, 1, 1, 2 ],
      [ 0, 1, 1, 1, 1, 1, 0, 0, 0, 1, 1, 2 ],
      [ 0, 1, 1, 1, 1, 1, 1, 0, 0, 1, 1, 2 ],
      [ 2, 1, 1, 1, 1, 1, 1, 0, 1, 1, 1, 2 ],
      [ 2, 1, 1, 1, 1, 1, 1, 0, 1, 4, 1, 0 ],
      [ 0, 1, 1, 1, 1, 0, 1, 0, 1, 1, 1, 0 ],
      [ 2, 1, 1, 1, 1, 1, 0, 0, 0, 1, 1, 2 ],
      [ 2, 2, 2, 2, 2, 0, 0, 0, 0, 0, 2, 2 ]
    ]
  },
  "Character": {
    "Position": {
      "x": 3,
      "y": 3
    },
    "Direction": "Top"
  },
  "Units": [
    {
      "Cost": 1,
      "UnitId": "Coin",
      "Position": {
        "x": 6,
        "y": 4
      }
    },
    {
      "Health": 150,
      "UnitId": "Skeleton",
      "Position": {
        "x": 2,
        "y": 8
      }
    }
  ]
}