{
  "Map": {
    "Tiles": [
      [ 2, 2, 2, 2, 2, 2, 2, 2, 2, 2, 2, 2 ],
      [ 2, 0, 1, 1, 1, 1, 1, 1, 1, 1, 0, 2 ],
      [ 2, 0, 1, 1, 1, 1, 1, 1, 4, 1, 0, 2 ],
      [ 2, 0, 1, 1, 1, 1, 1, 1, 1, 1, 0, 2 ],
      [ 2, 0, 1, 1, 1, 1, 1, 1, 1, 1, 0, 2 ],
      [ 2, 0, 1, 1, 1, 1, 1, 1, 1, 1, 0, 2 ],
      [ 2, 0, 1, 1, 1, 1, 1, 1, 1, 1, 0, 2 ],
      [ 2, 0, 1, 1, 1, 1, 1, 1, 1, 1, 0, 2 ],
      [ 2, 0, 1, 1, 1, 1, 1, 1, 1, 1, 0, 2 ],
      [ 2, 0, 1, 1, 1, 1, 1, 1, 1, 1, 0, 2 ],
      [ 2, 0, 1, 1, 1, 1, 1, 1, 1, 1, 0, 2 ],
      [ 2, 2, 2, 2, 2, 2, 2, 2, 2, 2, 2, 2 ]
    ]
  },
  "Character": {
    "Position": {
      "x": 3,
      "y": 3
    },
    "Direction": "Right"
  },
  "Units": []
}