{
  "Map": {
    "Tiles": [
      [ 2, 2, 2, 2, 2, 2, 2, 2, 2, 2, 2, 2 ],
      [ 2, 1, 1, 1, 1, 1, 1, 1, 1, 1, 1, 2 ],
      [ 2, 1, 1, 1, 1, 4, 1, 1, 1, 1, 1, 2 ],
      [ 2, 1, 1, 1, 1, 1, 1, 1, 1, 1, 1, 2 ],
      [ 2, 1, 1, 1, 1, 1, 1, 1, 1, 1, 1, 2 ],
      [ 2, 1, 1, 1, 1, 1, 1, 1, 1, 1, 1, 2 ],
      [ 2, 1, 1, 1, 1, 1, 1, 1, 1, 1, 1, 2 ],
      [ 2, 1, 1, 1, 1, 1, 1, 1, 1, 1, 1, 2 ],
      [ 2, 1, 1, 1, 1, 1, 1, 1, 1, 1, 1, 2 ],
      [ 2, 1, 1, 1, 1, 1, 1, 1, 1, 1, 1, 2 ],
      [ 2, 1, 1, 1, 1, 1, 1, 1, 1, 1, 1, 2 ],
      [ 2, 2, 2, 2, 2, 2, 2, 2, 2, 2, 2, 2 ]
    ]
  },
  "Character": {
    "Position": {
      "x": 5,
      "y": 3
    },
    "Direction": "Top"
  },
  "Units": []
}