{
  "Map": {
    "Tiles": [
      [ 2, 2, 2, 2, 2, 2, 2, 2, 2, 2, 2, 2 ],
      [ 2, 1, 1, 1, 1, 1, 1, 1, 1, 1, 1, 2 ],
      [ 2, 1, 0, 0, 0, 0, 0, 0, 0, 0, 1, 2 ],
      [ 2, 1, 0, 1, 1, 1, 1, 1, 1, 0, 1, 2 ],
      [ 2, 1, 0, 1, 0, 0, 0, 0, 1, 0, 1, 2 ],
      [ 2, 1, 0, 1, 1, 1, 4, 0, 1, 0, 1, 2 ],
      [ 2, 1, 0, 1, 1, 1, 1, 0, 1, 0, 1, 2 ],
      [ 2, 1, 0, 0, 0, 0, 0, 0, 1, 0, 1, 2 ],
      [ 2, 1, 1, 1, 1, 1, 1, 1, 1, 0, 1, 2 ],
      [ 2, 0, 0, 0, 0, 0, 0, 0, 0, 0, 1, 2 ],
      [ 2, 1, 1, 1, 1, 1, 1, 1, 1, 1, 1, 2 ],
      [ 2, 2, 2, 2, 2, 2, 2, 2, 2, 2, 2, 2 ]
    ]
  },
  "Character": {
    "Position": {
      "x": 1,
      "y": 1
    },
    "Direction": "Right"
  },
  "Units": [
    {
      "Cost": 1,
      "UnitId": "Coin",
      "Position": {
        "x": 10,
        "y": 6
      }
    },
    {
      "Cost": 1,
      "UnitId": "Coin",
      "Position": {
        "x": 3,
        "y": 10
      }
    },
    {
      "Cost": 20,
      "UnitId": "Chest",
      "Position": {
        "x": 4,
        "y": 5
      }
    }
  ]
}