{
  "Map": {
    "Tiles": [
      [ 2, 2, 2, 2, 2, 2, 2, 2, 2, 2, 2, 2 ],
      [ 2, 1, 1, 1, 1, 1, 1, 1, 1, 1, 1, 2 ],
      [ 2, 1, 1, 1, 1, 1, 1, 1, 1, 1, 1, 2 ],
      [ 2, 1, 1, 1, 0, 1, 1, 1, 1, 1, 1, 2 ],
      [ 2, 1, 1, 1, 0, 1, 1, 1, 1, 1, 1, 2 ],
      [ 2, 1, 1, 1, 0, 1, 1, 1, 1, 1, 1, 2 ],
      [ 2, 1, 1, 1, 0, 4, 1, 1, 1, 1, 1, 2 ],
      [ 2, 1, 1, 1, 0, 0, 0, 0, 1, 1, 1, 2 ],
      [ 2, 1, 1, 1, 1, 1, 1, 1, 1, 1, 1, 2 ],
      [ 2, 1, 1, 1, 1, 1, 1, 1, 1, 1, 1, 2 ],
      [ 2, 1, 1, 1, 1, 1, 1, 1, 1, 1, 1, 2 ],
      [ 2, 2, 2, 2, 2, 2, 2, 2, 2, 2, 2, 2 ]
    ]
  },
  "Character": {
    "Position": {
      "x": 3,
      "y": 3
    },
    "Direction": "Top"
  },
  "Units": []
}